14 10
0 0 0 1 2 0 
0 2 0 0 0 2
0 4 0 1 2 0 
0 7 0 0 1 2 
0 9 0 1 0 1
1 1 0 1 1 0
1 3 0 2 0 1
2 0 1 2 0 0 
2 4 1 1 1 0
2 6 0 0 1 1 
2 8 0 1 0 1
3 3 2 0 0 0 
3 5 0 0 1 0 
3 7 0 1 0 1 
4 1 1 1 1 0 
4 4 1 1 2 1 
4 6 0 0 0 2
4 9 1 2 0 0 
5 0 2 2 0 0 
5 5 0 0 2 0 
5 7 1 1 0 2 
6 2 0 0 2 0 
6 4 1 0 2 2 
6 6 0 0 0 2 
6 9 2 1 0 0 
7 1 1 1 1 0
7 3 0 2 0 1 
7 5 0 0 2 0 
7 7 1 1 0 2 
8 0 2 1 0 0 
8 2 0 2 0 0 
8 8 1 2 0 0 
9 1 1 2 0 0 
9 4 0 1 2 0 
9 7 1 1 0 2 
9 9 1 2 0 0 
10 0 1 1 0 0 
10 3 2 0 0 0 
10 5 0 2 0 0 
10 8 2 0 0 0 
11 2 2 0 1 0 
11 4 1 0 0 1
11 7 1 1 1 0 
11 9 2 0 0 1 
12 1 2 0 1 0 
12 5 2 0 0 1
13 0 1 0 2 0 
13 3 0 0 1 2
13 7 1 0 1 1
13 9 0 0 0 1