14 10
0 2 0 0 1 0 
0 4 0 0 1 1 
0 7 0 1 0 1 
0 9 0 1 0 0 
1 0 0 1 2 0 
1 3 0 1 1 2 
1 6 0 0 0 1
2 5 0 0 2 0 
2 7 1 1 1 2 
2 9 1 2 0 1 
3 1 0 0 2 0 
3 3 1 0 0 2 
4 0 1 1 1 0
4 2 0 1 1 1 
4 4 0 2 1 1 
4 6 0 2 0 1 
4 9 2 0 0 0 
5 1 0 1 0 0 
5 5 0 2 0 0 
6 0 1 2 0 0 
6 4 2 2 0 0
6 7 1 0 1 0 
6 9 0 2 0 1 
7 2 1 1 0 0 
7 6 2 1 2 0 
7 8 0 0 0 2 
8 0 2 1 0 0 
8 4 2 2 0 0 
9 2 1 1 0 0 
9 5 2 2 0 0 
9 7 0 1 1 0 
9 9 2 1 0 1 
10 1 1 1 0 0 
10 4 2 0 0 0 
10 6 1 1 0 0 
11 0 1 2 0 0 
11 2 1 0 2 0 
11 5 2 0 0 2 
11 7 1 0 1 0 
11 9 1 1 0 1
12 1 1 0 2 0 
12 3 0 0 1 2 
12 6 1 0 2 1 
12 8 0 0 0 2
13 0 2 0 1 0 
13 2 0 0 2 1 
13 4 0 0 1 2 
13 7 0 0 2 1 
13 9 1 0 0 2 