13 9 
0 1 0 1 1 0
0 4 0 1 1 1 
0 6 0 0 2 1 
0 8 0 0 0 2 
1 0 0 1 0 0 
2 1 1 0 2 0
2 3 0 2 0 2 
2 5 0 0 2 0 
2 8 0 1 0 2 
3 0 1 1 0 0 
3 4 1 1 1 0 
3 7 0 1 0 1 
4 1 0 1 2 0
4 3 2 0 0 2
4 6 0 1 0 0 
4 8 1 1 0 0 
5 0 1 2 0 0 
5 7 1 0 0 0 
6 1 1 1 1 0
6 4 1 0 1 1
6 6 1 0 0 1
7 0 2 1 0 0 
7 2 0 0 2 0 
7 5 0 0 1 2 
7 8 1 1 0 1 
8 1 1 1 1 0 
8 3 0 2 1 1 
8 7 0 1 0 1
9 0 1 1 0 0 
9 5 0 2 0 0 
9 8 1 2 0 0 
10 3 2 1 0 0 
10 7 1 0 0 0 
11 1 1 0 0 0 
12 0 1 0 2 0 
12 3 1 0 1 2 
12 5 2 0 1 1
12 8 2 0 0 1 