10 7 
0 1 0 1 2 0
0 5 0 1 0 2
1 0 0 2 0 0 
1 6 0 1 0 0 
2 1 1 0 2 0 
2 3 0 1 0 2
3 0 2 2 2 0 
3 2 0 0 0 2 
3 4 1 0 2 0 
3 6 1 2 0 2
4 1 0 1 1 0 
4 3 1 0 1 1 
4 5 0 1 0 1 
5 0 2 1 0 0 
5 2 0 0 1 0
5 4 0 2 0 1 
6 1 1 1 2 0
6 3 0 0 2 0 
6 6 2 1 0 0 
7 0 1 2 0 0 
7 5 1 1 0 0 
8 1 1 0 1 0 
8 4 2 0 0 1 
8 6 1 0 0 0 
9 0 2 0 1 0 
9 3 0 0 2 1
9 5 1 0 0 2