14 10
0 0 0 1 2 0 
0 3 0 0 1 2 
0 5 0 0 2 1 
0 8 0 0 0 2 
1 1 0 2 1 0 
1 4 0 1 2 1 
1 7 0 0 0 2
1 9 0 1 0 0 
2 0 1 1 0 0 
2 2 0 1 0 0 
2 5 0 0 2 0 
2 8 0 1 0 2 
3 1 2 2 0 0 
3 9 1 2 0 0 
4 0 1 1 0 0 
4 2 1 1 1 0 
4 4 1 1 1 1 
4 6 0 1 1 1 
4 8 1 0 0 1 
5 1 2 0 0 0 
5 3 0 1 0 0
5 5 0 2 0 0 
5 7 0 0 2 0
5 9 2 1 0 2
6 0 1 2 2 0 
6 2 1 1 0 2
6 6 1 1 2 0
6 8 0 0 0 2 
7 4 1 1 0 0 
7 7 0 0 1 0 
7 9 1 1 0 1
8 0 2 1 1 0 
8 2 1 0 0 1 
8 6 1 0 1 0 
8 8 0 0 0 1
9 5 2 0 1 0 
9 7 0 0 1 1 
9 9 1 1 0 1 
10 0 1 1 0 0 
10 3 1 1 0 0 
11 4 1 0 2 0
11 7 0 2 1 2 
11 9 1 0 0 1
12 0 1 0 1 0 
12 3 1 0 1 1 
12 5 0 0 0 1
13 1 0 0 2 0 
13 4 0 0 1 2 
13 7 2 0 2 1 
13 9 0 0 0 2 