14 10 
0 1 0 2 1 0 
0 3 0 0 1 1 
0 5 0 0 2 1 
0 9 0 1 0 2 
1 0 0 2 0 0 
1 2 0 1 1 0 
1 4 0 1 1 1
1 7 0 1 0 1 
2 1 2 0 0 0 
2 6 0 1 0 0 
3 0 2 1 1 0 
3 2 1 0 0 1 
3 7 1 1 1 0 
3 9 1 1 0 1 
4 1 0 1 1 0 
4 4 1 0 2 1 
4 6 1 1 0 2 
5 7 1 0 1 0 
5 9 1 1 0 1 
6 0 1 2 0 0 
6 3 0 0 2 0 
6 6 1 1 1 2 
6 8 0 0 0 1
7 1 1 2 1 0 
7 4 0 1 0 1 
7 7 0 2 2 0 
7 9 1 0 0 2 
8 0 2 1 0 0 
8 3 0 2 0 0 
8 6 1 2 0 0 
8 8 0 1 0 0 
9 1 2 1 0 0 
10 0 1 2 0 0 
10 4 1 1 0 0 
10 7 2 0 0 0 
10 9 0 2 0 0 
11 1 1 1 1 0 
11 3 2 0 0 1 
11 6 2 0 1 0 
11 8 1 0 0 1 
12 0 2 0 0 0
12 2 0 0 1 0 
12 4 1 0 1 1 
12 9 2 0 0 1 
13 1 1 0 2 0 
13 3 0 0 1 2 
13 5 0 0 2 1
13 7 0 0 0 2  