14 10 
0 0 0 2 1 0 
0 3 0 1 1 1 
0 5 0 1 2 1 
0 7 0 0 1 2 
0 9 0 2 0 1
1 5 0 1 2 0 
1 7 0 1 0 2 
2 1 0 1 1 0
2 3 1 2 0 1 
2 5 1 0 0 0 
2 9 2 1 0 0 
3 0 2 1 0 0 
3 6 1 0 0 0 
4 1 1 0 2 0 
4 3 2 0 2 2 
4 5 0 0 1 2 
4 8 1 0 0 1 
5 0 1 2 1 0 
5 2 0 0 1 1 
5 4 0 0 0 1
5 6 0 1 1 0
5 9 1 1 0 1 
6 1 0 1 0 0 
6 3 0 1 1 0
6 5 0 0 0 1
6 8 0 1 0 0 
7 0 2 2 0 0 
7 6 1 0 0 0 
7 9 1 1 0 0 
8 1 1 2 1 0 
8 3 1 2 1 1 
8 5 0 2 0 1 
8 8 1 2 0 0 
9 9 1 1 0 0 
10 0 2 1 0 0 
10 3 2 1 0 0 
10 6 0 1 2 0 
10 8 2 2 0 2 
12 1 2 0 0 0 
12 5 2 0 0 0 
12 9 1 0 0 0 
13 0 1 0 1 0 
13 3 1 0 1 1 
13 6 1 0 0 1
13 8 2 0 0 0 