14 10 
0 1 0 0 2 0 
0 4 0 0 1 2 
0 6 0 1 1 1 
0 8 0 0 0 1
1 0 0 1 1 0
1 2 0 0 2 1 
1 5 0 0 0 2 
2 1 0 0 2 0 
2 4 0 1 1 2 
2 6 1 0 1 1 
2 9 0 1 0 1 
4 0 1 1 1 0 
4 2 0 2 1 1 
4 4 1 0 1 1
4 7 0 0 1 1 
4 9 1 2 0 1 
5 1 0 1 0 0 
5 3 0 0 2 0 
5 6 0 1 0 2 
6 2 2 1 0 0 
6 4 0 1 0 0 
6 9 2 1 0 0 
7 0 1 1 0 0 
7 7 0 1 0 0 
8 2 1 2 1 0
8 4 1 0 1 1 
8 6 1 1 0 1 
9 0 1 2 0 0 
9 3 0 0 1 0 
9 5 0 1 0 1 
9 7 1 1 1 0 
9 9 1 1 0 1 
10 2 2 0 1 0 
10 4 0 0 0 1 
11 0 2 0 0 0 
11 6 1 0 0 0 
11 9 1 2 0 0 
12 3 0 0 2 0 
12 5 1 0 1 2 
12 7 1 0 0 1 
13 1 1 0 1 0 
13 4 0 0 2 1 
13 6 0 0 1 2 
13 9 2 0 0 1