11 8 
0 0 0 2 1 0 
0 2 0 0 1 1 
0 6 0 1 0 1 
1 1 0 2 1 0
1 4 0 1 0 1
2 0 2 2 0 0
2 2 0 2 0 0 
2 7 0 1 0 0 
3 1 2 0 0 0 
3 6 1 0 0 0 
4 0 2 1 2 0 
4 2 2 2 2 2 
4 4 1 0 1 2 
4 7 1 1 0 1
5 1 0 1 0 0 
5 3 0 0 1 0 
5 6 0 2 0 1 
6 0 1 1 0 0 
6 2 2 1 2 0
6 4 0 1 0 2 
6 7 1 1 0 0 
8 1 1 2 0 0 
8 4 1 0 1 0 
8 6 2 0 0 1 
9 0 1 0 0 0 
9 2 1 0 1 0 
9 5 0 0 0 1 
10 1 2 0 1 0 
10 3 0 0 1 1
10 7 1 0 0 1