11 8  
0 0 0 0 1 0 
0 2 0 2 1 1 
0 4 0 0 1 1 
0 7 0 2 0 1 
1 3 0 0 1 0
1 6 0 2 0 1
2 0 0 2 2 0
2 2 2 2 1 2 
2 4 0 1 0 1
2 7 2 1 0 0 
3 1 0 2 0 0 
3 6 2 1 0 0 
4 0 2 1 0 0 
4 3 0 1 0 0 
4 7 1 2 0 0 
5 2 2 0 0 0 
5 4 1 2 1 0 
5 6 1 0 0 1 
6 1 2 1 2 0 
6 3 1 0 0 1 
6 5 0 0 1 0 
6 7 2 1 0 1 
7 0 1 2 0 0 
7 2 0 0 2 0 
7 4 2 0 1 2
7 6 0 0 0 1 
8 1 2 1 1 0
8 3 0 0 1 1 
8 5 0 2 2 1 
8 7 1 0 0 2
9 0 2 0 0 0 
10 1 1 0 0 0 
10 3 0 0 2 0 
10 5 2 0 2 2 
10 7 0 0 0 2 