11 8  
0 0 0 2 2 0
0 3 0 0 1 2 
0 6 0 0 0 1 
1 1 0 1 2 0 
1 4 0 2 1 2
1 7 0 1 0 1 
2 0 2 1 0 0 
2 6 0 1 0 0 
3 1 1 0 1 0
3 3 0 0 0 1 
3 7 1 2 0 0 
4 0 1 2 2 0
4 2 2 2 0 0 
4 4 2 2 1 2 
4 6 1 0 0 1
5 1 0 2 1 0 
5 3 0 0 0 1 
5 5 0 2 2 0
5 7 2 1 0 2 
6 0 2 2 0 0 
6 6 0 2 0 0 
7 2 0 0 1 0 
7 4 2 1 0 1 
7 7 1 1 0 0 
8 0 2 1 0 0 
8 5 2 0 0 0 
9 1 2 0 1 0 
9 4 1 0 0 1
9 7 1 0 0 0 
10 0 1 0 2 0 
10 2 0 0 2 2 
10 6 2 0 0 2 