7 5  
0 1 0 2 1 0 
0 3 0 0 0 1 
1 0 0 2 0 0 
1 2 0 0 1 0
1 4 0 2 0 1 
2 1 2 2 2 0 
2 3 0 0 0 2
3 0 2 1 0 0 
4 1 2 0 1 0 
4 4 2 2 0 1
6 0 1 0 1 0 
6 2 0 0 1 1 
6 4 2 0 0 1 
