13 9 
0 0 0 1 1 0 
0 3 0 1 1 1 
0 6 0 0 2 1 
0 8 0 0 0 2 
1 1 0 1 0 0 
1 4 0 0 2 0
1 7 0 1 0 2
2 0 1 2 0 0 
2 8 0 1 0 0 
3 1 1 2 2 0
3 3 1 0 2 2
3 5 0 0 1 2 
3 7 1 1 0 1 
4 0 2 1 0 0 
4 2 0 1 2 0
4 4 0 2 1 2
4 6 0 0 0 1
4 8 1 2 0 0 
5 1 2 0 0 0 
5 3 0 2 0 0 
5 5 0 0 1 0 
5 7 1 1 0 1 
6 0 1 2 1 0 
6 2 1 0 0 1
6 4 2 1 2 0 
6 6 0 0 0 2
6 8 2 2 0 0 
7 5 0 0 1 0 
7 7 1 0 0 1 
8 0 2 0 1 0
8 3 2 0 0 1 
9 2 0 1 1 0
9 4 1 1 1 1
9 6 0 0 1 1 
9 8 2 1 0 1
10 0 0 2 0 0 
11 2 1 0 0 0
11 4 1 0 1 0
11 7 0 0 0 1
12 0 2 0 1 0
12 3 0 0 2 1 
12 5 0 0 1 2 
12 8 1 0 0 1