11 8
0 1 0 0 2 0 
0 3 0 1 2 2 
0 6 0 1 0 2
1 0 0 1 2 0
1 2 0 1 0 2
1 5 0 1 0 0 
1 7 0 1 0 0 
2 3 1 2 0 0 
2 6 1 2 0 0 
3 2 1 0 0 0 
4 0 1 1 2 0 
4 3 2 2 2 2 
4 5 1 0 0 2 
4 7 1 1 0 0 
5 4 0 1 1 0 
5 6 2 1 0 1 
6 1 0 0 2 0
6 3 2 1 0 2 
6 7 1 2 0 0 
7 0 1 2 2 0 
7 2 0 0 0 2 
7 5 0 1 0 0 
8 3 1 0 0 0 
8 7 2 1 0 0 
9 1 0 0 1 0 
9 4 1 0 0 1
9 6 1 0 0 0 
10 0 2 0 1 0 
10 2 0 0 1 1 
10 5 1 0 2 1 
10 7 1 0 0 2