14 10
0 1 0 1 1 0
0 3 0 2 1 1
0 6 0 0 1 1
0 8 0 1 0 1
1 0 0 2 0 0
1 9 0 1 0 0
2 3 2 0 1 0
2 5 0 0 1 1
2 7 0 0 0 1
3 1 1 0 1 0
3 4 0 0 0 1
3 9 1 2 0 0
4 0 2 0 1 0
4 3 0 2 1 1
4 6 0 0 1 1
4 8 1 2 0 1
5 4 0 0 2 0
5 7 0 1 0 2
6 0 0 2 1 0
6 2 0 0 0 1
6 9 2 1 0 0
7 1 0 0 2 0
7 3 2 1 1 2
7 5 0 0 1 1
7 7 1 1 0 1
8 0 2 2 1 0
8 2 0 1 0 1
8 4 0 0 1 0
8 6 0 2 0 1
8 8 2 0 0 0
9 1 0 1 0 0
9 3 1 1 1 0
9 5 0 2 0 1
9 7 1 1 2 0
9 9 1 1 0 2
10 0 2 2 0 0
10 2 1 0 0 0
10 6 2 2 0 0
10 8 0 1 0 0
11 5 2 0 0 0
11 7 1 0 0 0
11 9 1 2 0 0
12 1 1 0 1 0
12 3 1 0 1 1
12 6 2 0 1 1
12 8 1 0 0 1
13 0 2 0 1 0
13 2 0 0 1 1
13 5 0 0 2 1
13 7 0 0 1 2
13 9 2 0 0 1