8 11 
0 0 0 0 1 0 
2 0 0 2 1 1 
4 0 0 0 1 1 
7 0 0 2 0 1 
3 1 0 0 1 0
6 1 0 2 0 1
0 2 0 2 2 0
2 2 2 2 1 2 
4 2 0 1 0 1
7 2 2 1 0 0 
1 3 0 2 0 0 
6 3 2 1 0 0 
0 4 2 1 0 0 
3 4 0 1 0 0 
7 4 1 2 0 0 
2 5 2 0 0 0 
4 5 1 2 1 0 
6 5 1 0 0 1 
1 6 2 1 2 0 
3 6 1 0 0 1 
5 6 0 0 1 0 
7 6 2 1 0 1 
0 7 1 2 0 0 
2 7 0 0 2 0 
4 7 2 0 1 2
6 7 0 0 0 1 
1 8 2 1 1 0
3 8 0 0 1 1 
5 8 0 2 2 1 
7 8 1 0 0 2
0 9 2 0 0 0 
1 10 1 0 0 0 
3 10 0 0 2 0 
5 10 2 0 2 2 
7 10 0 0 0 2 

