8 11 
0 0 0 2 2 0
3 0 0 0 1 2 
6 0 0 0 0 1 
1 1 0 1 2 0 
4 1 0 2 1 2
7 1 0 1 0 1 
0 2 2 1 0 0 
6 2 0 1 0 0 
1 3 1 0 1 0
3 3 0 0 0 1 
7 3 1 2 0 0 
0 4 1 2 2 0
2 4 2 2 0 0 
4 4 2 2 1 2 
6 4 1 0 0 1
1 5 0 2 1 0 
3 5 0 0 0 1 
5 5 0 2 2 0
7 5 2 1 0 2 
0 6 2 2 0 0 
6 6 0 2 0 0 
2 7 0 0 1 0 
4 7 2 1 0 1 
7 7 1 1 0 0 
0 8 2 1 0 0 
5 8 2 0 0 0 
1 9 2 0 1 0 
4 9 1 0 0 1
7 9 1 0 0 0 
0 10 1 0 2 0 
2 10 0 0 2 2 
6 10 2 0 0 2 