5 7 
1 0 0 2 1 0 
3 0 0 0 0 1 
0 1 0 2 0 0 
2 1 0 0 1 0
4 1 0 2 0 1 
1 2 2 2 2 0 
3 2 0 0 0 2
0 3 2 1 0 0 
1 4 2 0 1 0 
4 4 2 2 0 1
0 6 1 0 1 0 
2 6 0 0 1 1 
4 6 2 0 0 1 

