8 11 
0 0 0 2 1 0 
2 0 0 0 1 1 
6 0 0 1 0 1 
1 1 0 2 1 0
4 1 0 1 0 1
0 2 2 2 0 0
2 2 0 2 0 0 
7 2 0 1 0 0 
1 3 2 0 0 0 
6 3 1 0 0 0 
0 4 2 1 2 0 
2 4 2 2 2 2 
4 4 1 0 1 2 
7 4 1 1 0 1
1 5 0 1 0 0 
3 5 0 0 1 0 
6 5 0 2 0 1 
0 6 1 1 0 0 
2 6 2 1 2 0
4 6 0 1 0 2 
7 6 1 1 0 0 
1 8 1 2 0 0 
4 8 1 0 1 0 
6 8 2 0 0 1 
0 9 1 0 0 0 
2 9 1 0 1 0 
5 9 0 0 0 1 
1 10 2 0 1 0 
3 10 0 0 1 1
7 10 1 0 0 1
