8 11
1 0 0 1 2 0
3 0 0 0 1 2 
5 0 0 1 1 1 
7 0 0 2 0 1 
0 1 0 2 0 0 
2 1 0 0 1 0 
4 1 0 1 0 1
1 2 1 0 2 0 
3 2 0 0 0 2
6 2 0 1 0 0 
0 3 2 2 2 0 
2 3 0 0 0 2 
5 3 1 0 0 0 
7 3 2 1 0 0
1 4 0 1 1 0
4 4 1 1 1 1 
6 4 1 1 0 1 
3 5 0 2 0 0 
7 5 1 2 0 0 
0 6 2 2 0 0 
4 6 1 1 0 0 
1 7 1 0 2 0
3 7 2 0 0 2 
6 7 1 1 0 0 
0 8 2 0 1 0
2 8 0 0 1 1 
4 8 1 1 0 1 
7 8 2 1 0 0 
6 9 1 0 0 0 
1 10 0 0 1 0
4 10 1 0 1 1
7 10 1 0 0 1


