7 10
1 0 0 1 2 0
5 0 0 1 0 2
0 1 0 2 0 0 
6 1 0 1 0 0 
1 2 1 0 2 0 
3 2 0 1 0 2
0 3 2 2 2 0 
2 3 0 0 0 2 
4 3 1 0 2 0 
6 3 1 2 0 2
1 4 0 1 1 0 
3 4 1 0 1 1 
5 4 0 1 0 1 
0 5 2 1 0 0 
2 5 0 0 1 0
4 5 0 2 0 1 
1 6 1 1 2 0
3 6 0 0 2 0 
6 6 2 1 0 0 
0 7 1 2 0 0 
5 7 1 1 0 0 
1 8 1 0 1 0 
4 8 2 0 0 1 
6 8 1 0 0 0 
0 9 2 0 1 0 
3 9 0 0 2 1
5 9 1 0 0 2