8 11
1 0 0 0 2 0 
3 0 0 1 2 2 
6 0 0 1 0 2
0 1 0 1 2 0
2 1 0 1 0 2
5 1 0 1 0 0 
7 1 0 1 0 0 
3 2 1 2 0 0 
6 2 1 2 0 0 
2 3 1 0 0 0 
0 4 1 1 2 0 
3 4 2 2 2 2 
5 4 1 0 0 2 
7 4 1 1 0 0 
4 5 0 1 1 0 
6 5 2 1 0 1 
1 6 0 0 2 0
3 6 2 1 0 2 
7 6 1 2 0 0 
0 7 1 2 2 0 
2 7 0 0 0 2 
5 7 0 1 0 0 
3 8 1 0 0 0 
7 8 2 1 0 0 
1 9 0 0 1 0 
4 9 1 0 0 1
6 9 1 0 0 0 
0 10 2 0 1 0 
2 10 0 0 1 1 
5 10 1 0 2 1 
7 10 1 0 0 2